1111111111111
1001000 001C1
1100011110001
1P0011CE00001
1111111111111