1111111111111
10010000001C1
1100011110011
1P0011CE00001
1111111111111